{
    "kh": "kʰ",
    "ny": "ɲ",
    "ng": "ŋ",
    "sy": "ʃ",
    "'": "ʔ",
    "a": "a",
    "b": "b",
    "c": "t͡ʃ",
    "d": "d",
    "è": "ɛ",
    "ê": "ə",
    "f": "f",
    "g": "ɡ",
    "h": "h",
    "i": "ɪ",
    "j": "d͡ʒ",
    "k": "k",
    "l": "l",
    "m": "m",
    "n": "n",
    "o": "o",
    "p": "p",
    "q": "k",
    "r": "r",
    "s": "s",
    "t": "t",
    "u": "u",
    "v": "f",
    "w": "w",
    "x": "ks",
    "y": "j",
    "z": "z"
}